R     1970 1070 

NO textures/texture1.xpm
SO textures/texture2.xpm
WE textures/texture3.xpm
EA textures/texture4.xpm

S textures/pillar.xpm
F 220, 100, 0
C 250 ,  30, 0


        111111111111111111111111111
        1000000000110000000000001
        1011000001110000002000001
        1001000000000000000000001
111111111011000001110000000000001
100000000110000011100000000111111
111101100000001110111100000010111                                
111101100000111011101010000001                              
110000001101010000000000000001                             
10002000000000000000000000001
10000000000000000000000000001
110000011101010010000000N0001
11110111 1110101 10000010001
11111111 1111111 111111111111